R 1920 1080
WE ./images/textures/catacomb3d/walls.xpm
SO ./images/textures/catacomb3d/walls.xpm
EA ./images/textures/catacomb3d/walls2.xpm
NO ./images/textures/catacomb3d/walls3.xpm
S ./images/sprites/mago.xpm
C 0,0,0
F 84,84,84


      11111111
1111111000000111111111111111111111
100000000000000W011100000000000001
1000000000000000011100000000000001
1000000011111111111100000110000001
100020000000000000010000011000000111111
100000000000002000010000011000000121211
111111111110000011110000011000000000021
100000000000000000000000011000000121211
100020000000020000000000011000000111111
1111111111111111111111111110000001
                          10000001
                          11111111