R 720 480
WE ./images/textures/catacomb3d/walls.xpm
SO ./images/textures/catacomb3d/walls.xpm
EA ./images/textures/catacomb3d/walls2.xpm
NO ./images/textures/catacomb3d/walls3.xpm
S ./images/sprites/alien_egg.xpm
C 0,0,0
F 84,84,84

       1111111
111111100000011111111111111111111
100000000000000W01110020200200001
100000000000000001110000000000001
100000001111111111110000011000001
100020000000000000010000011000001111111
100000000000002000010000011000000000001
111111111110000011110000011000000000001
100000000000000000000000011000000000001
100020000000020000000000011000000111111
1111111111111111111111111110002001
                          10000001
                          11111111