R 550 1000
WE ./images/textures/hovertank3d/blue.xpm
SO ./images/textures/hovertank3d/pink.xpm
EA ./images/textures/hovertank3d/darkblue.xpm
NO ./images/textures/hovertank3d/white.xpm
S ./images/sprites/alien.xpm
C 0,0,0
F 84,84,84


       
1111111111111111111111111111111
1000000000000000000000000000001
1011111111110001111100011110001
1010000000010001000100010210001
1010000200010001020000000010001
1011110011110001000100010010001
1010000000010001111100011110001
1010000000010000000000000000001
1010000200000000000000000000W01
1010000000010000000000000000001
1010000000010001111000111100001
1011110011110001001000100100001
1010000000010001200000000100001
1010000200010001001000100100001
1011111111110001111000111100001
1000000000000000000000000000001
1111111111111111111111111111111