R 100 720
WE ./images/textures/bricks.xpm
SO ./images/textures/eagle.xpm
EA ./images/textures/nicolas-cage.xpm
NO ./images/textures/nicolas-cage.xpm
S ./images/sprites/alien_egg.xpm
C 255,200,160
F 122,122,234

11111111111111111
10000000000000001
10200000200000201
10000000000000001
10002000000020001
10000000000000001
10202020S02020201
10000000000000001
10002000200200001
10000000000000001
10200000200002001
10000000000000001
11111111111111111

		 

		  
		   
			
			 



