R 1920 1080
WE ./images/textures/bricks.xpm
SO ./images/textures/eagle.xpm
EA ./images/textures/paper.xpm
NO ./images/textures/nicolas-cage.xpm
S ./images/sprites/alien_egg.xpm
C 255,200,160
F 122,122,234


11111111111
10000000001
110020000001111111
1111000W000011  11
11000000000011111
1111000000001111111111111111    
1000000000002000000000001
1100001100000001111111111
111111110002000011111
1111111100000000000011111
      1000000111000001
      11111111111111111

		 

		  
		   
			
			 



