R  856  15
NO ./images/textures/mandatory/bricks.xpm
SO ./images/textures/mandatory/greystone.xpm
WE ./images/textures/mandatory/redbrick.xpm
EA ./images/textures/mandatory/wood.xpm
S ./images/sprites/cage1.xpm
F 75, 88, 0
C 66,22, 0

        1111111111111111111111111
        1000000000110000000000001
        101100000111000N002000001
        1001000000000000002000001
111111111011000001110000000000001
100000000011000001110111111111111
11110111111111011100000010001
11110111111111011101010010201
11000000110101011100000010001
10002000000000001100000000001
10000000000000001101010010001
11000001110101011111011110001
11110111 1110101 101111010001
11111111 1111111 111111111111