R     1200    800 
NO                ./files/images/textures/north.xpm

SO        ./files/images/textures/south.xpm

WE    ./files/images/textures/west.xpm

EA         ./files/images/textures/east.xpm

S ./files/images/sprites/slugma.xpm

F    67,   136,    54
C       23, 120,    255



11111111111
10000000001
11002000001111111
1111000000011  11
11000E00000011111
11110000001111111111111111
10000000000002000000000001
11000011000000001111111111
111111110002000011111
1111111100000000000011111
      11000000111000001
      11111111111111111
