R     1200    800 
WE ./images/textures/news/tile242.xpm
SO ./images/textures/wood.xpm
EA ./images/textures/wood.xpm
NO ./images/textures/wood.xpm
S ./images/sprites/alien_egg.xpm

F    67 ,   136 ,    54
C       23  ,120 ,    255

1111111111
 10010020011111
111	1000010001
11010E000010110		 
  110002001111
 00010000001111
10101111101111	
1111	100001
	111110000111111111
  11111111111111