R 1920 1080
WE ./images/textures/wood.xpm
SO ./images/textures/wood.xpm
EA ./images/textures/wood.xpm
NO ./images/textures/wood.xpm
S ./images/sprites/alien_egg.xpm
C 255,200,160
F 122,122,234

11111111111
10000000001
11002000001111111
11110000000011  11
11000000000011111
1111000S00001111111111111111    
10000000000002000000000001
11000011000000001111111111
111111110002000011111
1111111100000000000011111
      1000000111000001
      11111111111111111


