F   125 , 100 , 15        
C 255,200,160

SO ./images/textures/mandatory/greystone.xpm
WE ./images/textures/mandatory/redbrick.xpm    
NO ./images/textures/mandatory/bricks.xpm
EA ./images/textures/mandatory/wood.xpm


S ./images/sprites/cage1.xpm

R 1080 720

11111111111111111            
100000000000000011111111111111111
10200000200000200000001                
10000000000000000000001                
100020002000200011111111111111111      
10000000000000001
10202020N02020201             
1000000000000000111111111111111111111
1000200020020000000000000000010000121
1000000000000000111111111111111111111
10200000200002001
10000000000000001
11111111111111111