F   125 , 100 , 15        
C 255,200,160

SO ./images/textures/mandatory/greystone.xpm
WE ./images/textures/mandatory/redbrick.xpm    
NO ./images/textures/mandatory/bricks.xpm
EA ./images/textures/mandatory/wood.xpm


S ./images/sprites/cage1.xpm

R 1080 720


11111111111111111
10000000000000001111111
10200000200000200000001
10000000000000000000001
10002000200020001111111
10000000000000001
10202020N02020201
10000000000000001
10002000200200001
10000000000000001
10200000200002001
10000000000000001
11111111111111111
