F   125 , 100 , 15        
C 255,200,160
SO 
WE ./images/textures/mandatory/redbrick.xpm    
NO ./images/textures/mandatory/bricks.xpm
EA ./images/textures/mandatory/wood.xpm
S ./images/sprites/cage1.xpm
R  500 500

 1111111111111111111111111111111111
 1000000000000000111111111111111111
 1020000020000020000000002000010001
 1000000000000000111111111111111111
 10002000200020001   1
 10000000000000001   11111111111
 10202020N02020201   10002000011
 10000000000000001   11111111111
 10002000200200001   1
 11000000000000001   1
 10200000200002001   11111111111
 10000000000000001   11020202021
 11111111111111111   11111111111