F   125 , 100 , 15        
C 255,200,160
SO ./images/textures/mandatory/bricks.xpm
WE ./images/textures/mandatory/redbrick.xpm    
NO  ./images/textures/mandatory/redbrick.xpm    
EA ./images/textures/mandatory/wood.xpm
S ./images/sprites/cage1.xpm
R  500 500

 1111111111111111111111111111111111
 1000000000000000111111111111111111
 1000000000000000000000000000010001
 1000000000000000111111111111111111
 10000000000000001   1
 10000000000000001   11111111111
 10000000N00000001   10000000011
 10000000000000001   11111111111
 10000000000000001   1
 11000000000000001   1
 10000000000000001   11111111111
 10000000000000001   11000000001
 11111111111111111   11111111111