F   125 , 100 , 15        
C 255,200,160
SO ./images/textures/mandatory/greystone.xpm
WE ./images/textures/mandatory/redbrick.xpm    
NO ./images/textures/mandatory/bricks.xpm
EA ./images/textures/mandatory/wood.xpm
S ./images/sprites/cage1.xpm
R 1080 720
   
 1111111111111111111111111111111111
 1000000000000000111111111111111111
 1020000020000020000000002000010001
 1000000000000000111111111111111111
 10002000200020001    1
 10000000000000001    11111111111
 10202020N02020201    10002000011
 10000000000000001    11111111111
 100020002002000011   1
 110000000000000001   1
 102000002000020011   11111111111
 10000000000000001    11020202021
 11111111111111111    11111111111