R 1920 1080
WE ./images/textures/wolfenstein/bluestone.xpm
SO ./images/textures/wolfenstein/bluestone.xpm
EA ./images/textures/wolfenstein/stone.xpm
NO ./images/textures/wolfenstein/bluestone.xpm
S ./images/sprites/robot.xpm
C 57,55,57
F 84,84,84



   11111111111111111111
   10000000000012000021
   10000000020011000011
   10000000000012000021
   11110111111111000011
   10000000111111101111
   10000000000000000011
   10000000111111111111
11111110111111111111111111111111111111
11111000001111111111111111000110001001
11000000000000111111111111020110001001
11000000000000111111111111000110001001
11000200000000111111111111000110001001
11000200000000011111111111101111011001
10000200000000011111111100000000000001
10000200000000000000000000000000000001
10000200000000011111111100000000000001
11000000000000011111111111101111011001
11000200000000111111111111000110001001
11000022220000111111111111000110001001
11000000000000111111111111000110N01021
11111111111111111111111111000110201001
11111111111111111111111111111111111111